{
  "tileSize": 32,
  "width": 28,
  "height": 9,
  "solid": [
    "############################",
    "#............##............#",
    "#............##............#",
    "#..........................#",
    "#....######........######..#",
    "#..........................#",
    "#............##............#",
    "#............##............#",
    "############################"
  ]
}
